PPPPPPPPPPPPPPPPPPPPPPPP
P  P  M            VP  P
P  P        E       P  P
P  P                P  P
P  PPPPP    M   PPPPP  P
P               PP     P
P    M           M     P
P             P      V P
P      M     PPPPPPPPPPP
P           PP       J P
P         PP           P
P    PP                P
P   M PP             M P
P     PPP              P
P V    PPPP     M      P
PPPPPPPPPPPPPPPPPPPPPPPP