PPPPPPPPPPPPPPPPPPPPPPPP
P    M        PPPP   M P
PPPPP    PP   M P      P
P   PPPPP      P       P
P      M    V PP       P
P         PPPP         P
P     PP       PP      P
P      PPPP PPPP       P
P         PPP          P
P      J  PP           P
P  M     PPP    PP  M  P
P        E P      PPPP P
PPPPPPPPPPPP         PPP
P  V       PP          P
P     PP       M       P
PPPPPPPPPPPPPPPPPPPPPPPP
