PPPPPPPPPPPPPPPPPPPPPPPP
P V  M               M P
P       P     M    P   P
P      PP          PP  P
P  PPPP          PPPPP P
P P             PP  PPPP
PP   M         P M     P
P             P      V P
P      M          PPPPPP
P               PPP   EP
P  M           PP      P
P              PP      P
P        PPP   P       P
P       PP             P
P J     PP      M      P
PPPPPPPPPPPPPPPPPPPPPPPP