PPPPPPPPPPPPPPPPPPPPPPPP
P                      P
P                  J   P
P                      P
P                      P
P                      P
P                      P
P              M       P
P                      P
P           P          P
P   M     P            P
P         E P          P
PPPPPPPPPPPPPPPPPPPPP PP
P                      P
P              M       P
PPPPPPPPPPPPPPPPPPPPPPPV
