PPPPPPPPPPPPPPPPPPPPPPPP
P V  M        PPPP  J  P
P             M PP     P
P     PPP      PP      P
P    PP  M    PP       P
P   PP                 P
PPPPPPPPPPPP     M     P
P E           M        P
P  P           PPPPPPPPP
P MPP          P V     P
P  PPP        PP       P
P PP                   P
PP           PPPP      P
P    M      PPP        P
P          PPP    M    P
PPPPPPPPPPPPPPPPPPPPPPPP