PPPPPPPPPPPPPPPPPPPPPPPP
PPPP  M         M   PPPP
P  PPP            PPP  P
P    PPPP      PPPP    P
P           M       V  P
P   V       P          P
PPP    M    P    M   PPP
P PP        P       PP P
P  PP       P      PP  P
P   PPP     P    PPP V P
P           P          P
P           M          P
P    PPPP      PPPP  M P
P EPPP            PPP  P
PPPP        J       PPPP
PPPPPPPPPPPPPPPPPPPPPPPP