PPPPPPPPPPPPPPPPPPPPPPPP
P    M        PPPP     P
P             M P      P
P              P       P
P      M    V PP       P
P         PPPP         P
P                M     P
P             M        P
P                      P
P      J   P           P
P  M     P             P
P        E P           P
PPPPPPPPPPPP           P
P                      P
P              M      VP
PPPPPPPPPPPPPPPPPPPPPPPP
