PPPPPPPPPPPPPPPPPPPPPPPP
P J   M   P  P   M     P
P        PP  PP        P
P       PPP  PPP       P
P    PPPPV     PPPP V  P
P                      P
PPPPPPPPP   E  PPPPPPPPP
P        M         M   P
P  PPPP          PPPP  P
PPPP                PPPP
P     PP M      PP     P
P M  PP     M    PP    P
P    PPPP      PPPP  M P
P EPPP            PPP  P
PPPP  V     M    V  PPPP
PPPPPPPPPPPPPPPPPPPPPPPP