PPPPPPPPPPPPPPPPPPPPPPPP
P V     P              P
P   M   P   J  PP      P
PPP     P     PP       P
P PPP   PPP  PP    M   P
P       PPPPPP         P
P M     M  PP          P
P   PP         M       P
P  PPPP    V         E P
PPPP  PP   PP     PPPPPP
P   M  P   P    PPP  M P
P         EP           P
PPPPPPPPPPPPPPPPPPP    P
P  P     PM          V P
P  V P         M       P
PPPPPPPPPPPPPPPPPPPPPPPP
